11111111111111111
1000000000000E001
10000000000000001
10000000000000001
10010000000000011
10000000000000011
1000000000000C001
1000000000000P000
11111111111111111