11111111111111111
1000000000000E001
100X0000000000001
100000000000X0001
10010000000000011
10000000000000011
1000000C00000C001
1000000000000P111
11111111111111111