1111111111
1000000E01
1CCCEP0001
1111111111