11111111111111111
10000C000C000E001
1000C0000000C0001
1000000C000C00001
10000000C000000E1
100C00C0000000001
1000000000C000001
1000000000000P011
11111111111111111